NO ./textures/cursed/barbie.xpm
SO ./textures/cursed/cat.xpm
WE ./textures/misc/cloud_rainbow.xpm
EA ./textures/misc/cloud_rainbow.xpm

F 180, 255, 150
C 230, 180, 255

1111111111111111111111111                     111111111111111111111
1000000000110000010000001                     100000000000000000001
101100S001110000000000001                     101100000000000000001
1001000000000000000000001                     100000000000000000001
1001000000100000010000001                     100000000000000000001
1011111100100000000000001111111111111111111111100000000000000010001
1000000001010000000000000000000000000000000000000000000000000000001
1001000000100000000000001111111110011111111111100000000100011000001
1011000001111111111100001      110011         100000001100100100001
1000000000110000010000001      100001         101100011100100100001
1001000000000000010000001     1000000111111111110000110100000100001
1011000001110000010000001     1000000000000000000001111100001000001
1000000000110000010000001      100001111111111110000000100010000001
1000000000000000000000001       10010000000000010000000100111110001
1111111111111111111101111111111111100000000000011111111110011111111
                   10000000000000000000000000000000000000001    
                   11111111111111111111111111111111111111111 
