NO ./textures/lab42/crystal_sign.xpm
SO ./textures/lab42/crystal.xpm
WE ./textures/lab42/crystal_box.xpm
EA ./textures/lab42/crystal_imac.xpm

C 207,233,247
F 130,170,210

1111111111111111111
1001001001001001001
1001001001001001001
1001001001001001001
1001001000001001001
1000000000E00000001
1000011111111000001
1111000000000001111
1000000101010000001
1111111111111111111
