NO ./textures/westeros/stark.xpm
SO ./textures/westeros/baratheon.xpm
WE ./textures/westeros/lannister.xpm
EA ./textures/westeros/targaryen.xpm

F 28, 28, 28
C 105, 105, 105

111111111111111111111111
1S0000000001000000000001
101111111001011111111101
101000001000010000001001
101011101110011101110101
101010100000000001010101
100010101111111010100001
101010100000000001010101
101011101110011101110101
101000001000010000001001
101111111001011111111101
100000000000000000000001
111111111111111111111111
