NO ./textures/north.xpm
SO ./textures/south.xpm
WE ./textures/west.xpm
EA ./textures/east.xpm

C 135,206,235
F 123,230,81

11111111111
10000011  1
11100111  1
11100111111
10000001
100W0001
11111111