NO ./textures/mario/mario_1.xpm
SO ./textures/mario/mario_3.xpm
WE ./textures/mario/mario_2.xpm
EA ./textures/mario/mario_4.xpm

C 92, 148, 252
F 128, 208, 15

11111111111111111111111
100S0010000100010000111
11000000000000000000111
10000000011111000000011
10010000000000000001111
10000010000000000111111
11101011000100000000011
10000011000100000000001
11000001000100100000111
11000000010110001011111
11011000001110000000111
11111111111111111111111
