NO ./textures/north.xpm
SO ./textures/south.xpm
WE ./textures/west.xpm
EA ./textures/east.xpm

C 135,206,235
F 123,230,81

11111111
10000N01
11100101
10000001
10000111
10100001
10100001
11111111