11111111
10000001
11100101
10000001
10000111
10100001
10100001
11111111
