NO ./textures/test/north.xpm
SO ./textures/test/south.xpm
WE ./textures/test/west.xpm
EA ./textures/test/east.xpm

C 135,206,235
F 123,230,81

1111111  1111
             111111111
1111111  1111
1000001  1  1
1110011  1  1
1110011  1111
10000001
100W0001
11111111