11111
1 001
11001
1W001
11111
